xxxxx
x*B*x
xb**x
x***x
xx*xx
x***x
x***x
x***x
xxxxx
