xxxxx xxxx
x***xGx**x
x*b***g**x
xx**B*B**xx
 G**g**G
xx**B*B*xxx
x*g*p*b***x
x***xGx***x
xxxxx xxxx