xxxxx
x*B*x
xb*rx
x***x
xx*xx
x***x
x*p*x
x***x
xxxxx
