xxxxx
x*B*x
xb*gx
x***x
xxrxx
x***x
x*p*x
x***x
xxxxx
