xxxxxxx
xx****x
x*rGb*x
x*gp**x
x*B*R*x
x****xx
xxxxxxx