Level 3: Center Dilemma
 xxxx xxxx
x***xGx***x
x**b***g**x
xx**B*B**xx
 G***g***G
xx**B*B**xx
x**g*p*b**x
x***xGx***x
 xxxx xxxx