Level 2: Triangle Tango
xxxxxxx
xx***6x
x*r6Gxb*6x
x*g*p**6x
x6Bx6Rx6x
x***6xx
xxxxxxx