Level 3: Center Dilemma
 xxxx xxxx
x**6xGxx**6x
x**b****g**6x
xx*6Bx6Bx*6xx
 Gx***g***6Gx
xx*6Bx6Bx*6xx
x**g**p**b**6x
x**6xGxx**6x
 xxxx xxxx