Level 4: Mostly Solved
xxxxBxxxxxGxxxx
x*x***x*x***x*x
x**x*x***x*x**x
B***b**R**g**Gx
x**x*x*p*x*x**x
x*x*r*xbx***x*x
x*************x
xxxxxxxxxxGxxxx